0,0,0,0,1,0
0,1,1,0,1,0
0,2,0,0,1,0
0,3,1,0,1,0
0,4,0,0,1,0
1,0,1,0,1,0
1,1,0,0,1,0
1,2,1,0,1,0
1,3,0,0,1,0
1,4,1,0,1,0
2,0,0,0,1,0
2,1,1,0,1,0
2,2,0,0,1,0
2,3,1,0,1,0
2,4,0,0,1,0
3,0,1,0,1,0
3,1,0,0,1,0
3,2,1,0,1,0
3,3,0,0,1,0
3,4,1,0,1,0
5,0,0,0,1,0
5,1,1,0,1,0
5,2,0,0,1,0
5,3,1,0,1,0
5,4,0,0,1,0